9 11 11 11 11 11 11 11 11 11 11 11 11 11 11 11 11 11 11 11 11 11 11 11 11 11 11 11 11 11 11 11 11 11 11 11 11 11 11 11 11 11 11 11 11 11 11 11 11 8
2 10 10 10 10 10 10 10 10 10 10 10 10 10 10 10 10 10 10 10 10 10 10 10 10 10 10 10 10 10 10 10 10 10 10 10 10 10 10 10 10 10 10 10 10 10 10 10 10 4
2 43 41 41 41 41 41 41 41 41 41 41 41 41 41 41 41 41 41 41 41 41 41 41 41 10 1 1 1 1 10 41 41 41 41 41 41 41 41 41 41 41 41 41 41 41 41 41 41 4
2 43 41 41 41 41 41 41 41 41 41 41 41 41 41 41 41 41 41 41 41 41 41 41 41 10 1 1 1 1 10 41 41 41 41 41 41 41 41 41 41 41 41 41 41 41 41 41 41 4
2 43 41 41 41 41 41 41 41 41 41 41 41 41 41 41 41 41 41 41 41 41 41 41 41 10 1 1 1 1 10 41 41 41 41 41 41 41 41 41 41 41 41 41 41 41 41 41 41 4
2 43 41 41 41 41 41 41 41 41 41 41 41 41 41 41 41 41 41 41 41 41 41 41 41 10 1 1 1 1 10 41 41 41 41 41 41 41 41 41 41 41 41 41 41 41 41 41 41 4
2 43 41 41 41 41 41 41 41 41 41 41 41 41 41 41 41 41 41 41 45 45 41 41 41 10 1 1 1 1 10 41 41 41 41 41 41 41 41 41 41 41 41 41 41 41 41 41 41 4
2 43 41 41 41 41 41 41 41 41 41 41 41 41 41 41 41 41 41 45 45 45 45 45 41 10 1 1 1 1 10 41 41 41 41 41 41 41 41 41 41 41 41 41 41 41 41 41 41 4
2 43 41 41 41 41 41 41 41 41 41 42 42 42 41 41 41 41 45 45 45 45 45 45 45 10 44 10 10 10 10 41 41 41 41 41 41 41 41 41 41 41 41 41 41 41 41 41 41 4
2 43 41 41 41 41 41 41 41 41 41 42 42 42 41 41 41 41 45 45 45 45 45 45 45 41 44 41 41 41 41 41 41 41 41 41 41 41 41 41 41 41 41 41 41 41 41 41 41 4
2 43 41 41 41 41 41 41 41 41 41 42 42 42 41 41 41 41 45 45 45 45 45 45 41 41 44 41 41 41 41 41 41 41 41 41 41 41 41 41 41 41 41 41 41 41 41 41 41 4
2 43 41 41 41 41 41 41 41 41 41 41 44 41 41 41 41 41 41 45 45 45 45 45 44 44 44 44 44 44 44 44 44 41 41 41 41 41 41 41 41 41 41 41 41 41 41 41 41 4
2 43 41 41 41 41 41 41 41 41 41 41 44 41 41 41 41 41 41 45 45 45 45 41 41 41 44 41 41 41 41 41 41 41 41 41 41 41 41 41 41 41 41 41 41 41 41 41 41 4
2 43 41 41 41 41 41 41 41 41 41 41 44 41 41 41 41 41 41 40 42 42 40 41 41 41 44 41 41 41 41 41 41 41 41 41 41 41 41 41 41 41 41 41 41 41 41 41 41 4
2 43 41 41 41 41 41 41 41 41 41 41 44 41 41 41 41 41 41 40 44 44 40 41 41 41 44 41 41 41 41 41 41 41 41 41 41 41 41 41 41 41 41 41 41 41 41 41 41 4
2 43 41 41 41 41 41 41 41 41 41 41 44 41 41 41 41 41 41 40 44 44 40 41 41 41 44 41 41 40 40 40 40 40 40 40 41 41 41 41 41 41 41 41 41 41 41 41 41 4
2 43 41 41 41 41 41 41 41 41 41 41 44 41 41 41 41 41 41 40 44 44 40 41 41 41 44 41 41 40 44 44 44 44 44 40 41 41 41 41 41 41 41 41 41 41 41 41 41 4
2 43 41 41 41 41 41 41 41 41 41 41 44 41 41 41 41 41 41 40 44 44 40 46 46 46 44 46 46 40 44 44 44 44 44 40 41 41 41 41 41 41 41 41 41 41 41 41 41 4
2 43 41 41 41 41 41 41 41 41 41 41 44 41 41 41 41 41 41 40 44 44 44 44 44 44 44 44 44 44 44 44 44 44 44 40 41 41 41 41 41 41 41 41 41 41 41 41 41 4
2 43 41 41 41 41 41 41 41 41 41 41 44 41 41 41 41 41 41 40 44 44 40 40 40 40 44 46 46 40 44 44 44 44 44 40 41 41 41 41 41 41 41 41 41 41 41 41 41 4
2 43 41 41 41 41 41 41 41 41 41 41 44 41 41 41 41 41 41 40 44 44 40 42 42 40 44 41 41 40 44 44 44 44 44 40 41 41 41 41 41 41 41 41 41 41 41 41 41 4
2 43 41 41 41 41 41 41 41 41 41 41 44 41 41 41 41 41 41 40 44 44 40 42 42 40 44 41 41 40 40 40 40 40 40 40 41 41 41 41 41 41 41 41 41 41 41 41 41 4
2 43 41 41 41 41 41 41 41 41 41 41 44 41 41 41 41 41 41 40 44 44 40 40 42 41 44 41 41 41 41 41 41 41 41 41 41 41 41 41 41 41 41 41 41 41 41 41 41 4
2 43 41 41 41 41 41 41 46 46 46 46 44 46 46 46 46 46 40 44 44 44 44 40 40 40 44 46 46 46 46 46 46 46 46 46 46 46 46 46 46 46 46 46 46 46 46 46 46 4
2 43 41 41 41 44 44 44 44 44 44 44 44 44 44 44 44 44 44 44 44 44 44 44 44 44 44 44 44 44 44 44 44 44 44 44 44 44 44 44 44 44 44 44 44 44 44 44 44 4
2 43 41 41 41 44 44 44 44 44 44 44 44 44 44 44 44 44 44 44 44 44 44 44 44 44 44 44 44 44 44 44 44 44 44 44 44 44 44 44 44 44 44 44 44 44 44 44 44 4
2 43 41 41 41 41 41 41 41 41 41 41 41 46 46 46 46 46 40 44 44 44 44 41 41 41 41 41 41 41 41 41 41 41 41 41 41 41 41 41 41 41 41 41 41 41 41 41 41 4
2 43 41 41 41 41 41 41 41 41 41 41 41 41 41 41 41 41 41 41 44 44 41 41 41 41 41 41 41 41 41 41 41 41 41 41 41 41 41 41 41 41 41 41 41 41 41 41 41 4
2 43 41 41 41 41 41 41 41 41 41 41 41 41 41 41 41 41 41 41 41 41 41 41 41 41 41 41 41 41 41 41 41 41 41 41 41 41 41 41 41 41 41 41 41 41 41 41 41 4
2 43 41 41 41 41 41 41 41 41 41 41 41 41 41 41 41 41 41 41 41 41 41 41 41 41 41 41 41 41 41 41 41 41 41 41 41 41 41 41 41 41 41 41 41 41 41 41 41 4
2 43 41 41 41 41 41 41 41 41 41 41 41 41 41 41 41 41 41 41 41 41 41 41 41 41 41 41 41 41 41 41 41 41 41 41 41 41 41 41 41 41 41 41 41 41 41 41 41 4
2 43 41 41 41 41 41 41 41 41 41 41 41 41 41 41 41 41 41 41 41 41 41 41 41 41 41 41 41 41 41 41 41 41 41 41 41 41 41 41 41 41 41 41 41 41 41 41 41 4
2 43 41 41 41 41 41 41 41 41 41 41 41 41 41 41 41 41 41 41 41 41 41 41 41 41 41 41 41 41 41 41 41 41 41 41 41 41 41 41 41 41 41 41 41 41 41 41 41 4
2 43 41 41 41 41 41 41 41 41 41 41 41 41 41 41 41 41 41 41 41 41 41 41 41 41 41 41 41 41 41 41 41 41 41 41 41 41 41 41 41 41 41 41 41 41 41 41 41 4
2 43 41 41 41 41 41 41 41 41 41 41 41 41 41 41 41 41 41 41 41 41 41 41 41 41 41 41 41 41 41 41 41 41 41 41 41 41 41 41 41 41 41 41 41 41 41 41 41 4
2 43 41 41 41 41 41 41 41 41 41 41 41 41 41 41 41 41 41 41 41 41 41 41 41 41 41 41 41 41 41 41 41 41 41 41 41 41 41 41 41 41 41 41 41 41 41 41 41 4
2 43 41 41 41 41 41 41 41 41 41 41 41 41 41 41 41 41 41 41 41 41 41 41 41 41 41 41 41 41 41 41 41 41 41 41 41 41 41 41 41 41 41 41 41 41 41 41 41 4
2 43 41 41 41 41 41 41 41 41 41 41 41 41 41 41 41 41 41 41 41 41 41 41 41 41 41 41 41 41 41 41 41 41 41 41 41 41 41 41 41 41 41 41 41 41 41 41 41 4
2 43 41 41 41 41 41 41 41 41 41 41 41 41 41 41 41 41 41 41 41 41 41 41 41 41 41 41 41 41 41 41 41 41 41 41 41 41 41 41 41 41 41 41 41 41 41 41 41 4
2 43 41 41 41 41 41 41 41 41 41 41 41 41 41 41 41 41 41 41 41 41 41 41 41 41 41 41 41 41 41 41 41 41 41 41 41 41 41 41 41 41 41 41 41 41 41 41 41 4
2 43 41 41 41 41 41 41 41 41 41 41 41 41 41 41 41 41 41 41 41 41 41 41 41 41 41 41 41 41 41 41 41 41 41 41 41 41 41 41 41 41 41 41 41 41 41 41 41 4
2 43 41 41 41 41 41 41 41 41 41 41 41 41 41 41 41 41 41 41 41 41 41 41 41 41 41 41 41 41 41 41 41 41 41 41 41 41 41 41 41 41 41 41 41 41 41 41 41 4
2 43 41 41 41 41 41 41 41 41 41 41 41 41 41 41 41 41 41 41 41 41 41 41 41 41 41 41 41 41 41 41 41 41 41 41 41 41 41 41 41 41 41 41 41 41 41 41 41 4
2 43 41 41 41 41 41 41 41 41 41 41 41 41 41 41 41 41 41 41 41 41 41 41 41 41 41 41 41 41 41 41 41 41 41 41 41 41 41 41 41 41 41 41 41 41 41 41 41 4
2 43 41 41 41 41 41 41 41 41 41 41 41 41 41 41 41 41 41 41 41 41 41 41 41 41 41 41 41 41 41 41 41 41 41 41 41 41 41 41 41 41 41 41 41 41 41 41 41 4
2 43 41 41 41 41 41 41 41 41 41 41 41 41 41 41 41 41 41 41 41 41 41 41 41 41 41 41 41 41 41 41 41 41 41 41 41 41 41 41 41 41 41 41 41 41 41 41 41 4
2 43 41 41 41 41 41 41 41 41 41 41 41 41 41 41 41 41 41 41 41 41 41 41 41 41 41 41 41 41 41 41 41 41 41 41 41 41 41 41 41 41 41 41 41 41 41 41 41 4
2 43 41 41 41 41 41 41 41 41 41 41 41 41 41 41 41 41 41 41 41 41 41 41 41 41 41 41 41 41 41 41 41 41 41 41 41 41 41 41 41 41 41 41 41 41 41 41 41 4
2 43 41 41 41 41 41 41 41 41 41 41 41 41 41 41 41 41 41 41 41 41 41 41 41 41 41 41 41 41 41 41 41 41 41 41 41 41 41 41 41 41 41 41 41 41 41 41 41 4
2 43 41 41 41 41 41 41 41 41 41 41 41 41 41 41 41 41 41 41 41 41 41 41 41 41 41 41 41 41 41 41 41 41 41 41 41 41 41 41 41 41 41 41 41 41 41 41 41 4
2 43 41 41 41 41 41 41 41 41 41 41 41 41 41 41 41 41 41 41 41 41 41 41 41 41 41 41 41 41 41 41 41 41 41 41 41 41 41 41 41 41 41 41 41 41 41 41 41 4
5 6 6 6 6 6 6 6 6 6 6 6 6 6 6 6 6 6 6 6 6 6 6 6 6 6 6 6 6 6 6 6 6 6 6 6 6 6 6 6 6 6 6 6 6 6 6 6 6 7