9 11 11 11 11 11 11 11 11 11 11 11 11 11 11 11 11 11 11 11 11 11 11 11 11 11 11 11 11 11 11 11 11 11 11 11 11 11 11 11 11 11 11 11 11 11 11 11 11 8
2 0 0 0 0 0 0 0 0 0 0 0 0 0 0 0 0 0 0 0 0 0 0 0 0 0 0 0 0 0 0 0 0 0 0 0 0 0 0 0 0 0 0 0 0 0 0 0 0 4
2 0 5 6 6 6 6 7 0 5 6 6 6 6 7 0 5 6 6 6 6 7 0 5 6 6 6 6 7 0 5 6 6 6 6 7 0 5 6 6 6 6 7 0 5 6 6 6 7 4
2 0 2 0 0 0 0 3 0 2 0 0 0 0 3 0 2 0 0 0 0 3 0 2 0 0 0 0 3 0 2 0 0 0 0 3 0 2 0 0 0 0 3 0 2 0 0 0 0 3
2 0 2 0 5 6 6 7 0 2 0 5 6 6 7 0 2 0 5 6 6 7 0 2 0 5 6 6 7 0 2 0 5 6 6 7 0 2 0 5 6 6 7 0 2 0 5 6 6 7
2 0 2 0 2 0 0 0 0 2 0 2 0 0 0 0 2 0 2 0 0 0 0 2 0 2 0 0 0 0 2 0 2 0 0 0 0 2 0 2 0 0 0 0 2 0 2 0 0 0
2 0 2 0 2 0 5 6 6 7 0 2 0 5 6 6 7 0 2 0 5 6 6 7 0 2 0 5 6 6 7 0 2 0 5 6 6 7 0 2 0 5 6 6 7 0 2 0 5 6
6 7 4 2 0 2 0 2 0 2 0 0 0 0 2 0 2 0 0 0 0 2 0 2 0 0 0 0 2 0 2 0 0 0 0 2 0 2 0 0 0 0 2 0 2 0 0 0 0 2
0 2 0 3 4 2 0 2 0 2 0 2 0 5 6 6 7 0 2 0 5 6 6 7 0 2 0 5 6 6 7 0 2 0 5 6 6 7 0 2 0 5 6 6 7 0 2 0 5 6
6 7 0 2 0 5 6 7 4 2 0 2 0 2 0 2 0 2 0 0 0 0 2 0 2 0 0 0 0 2 0 2 0 0 0 0 2 0 2 0 0 0 0 2 0 2 0 0 0 0
2 0 2 0 0 0 0 2 0 2 0 3 4 2 0 2 0 2 0 2 0 2 0 5 6 6 7 0 2 0 5 6 6 7 0 2 0 5 6 6 7 0 2 0 5 6 6 7 0 2
0 5 6 6 7 0 2 0 5 6 6 7 0 2 0 5 6 7 4 2 0 2 0 2 0 2 0 2 0 2 0 0 0 0 2 0 2 0 0 0 0 2 0 2 0 0 0 0 2 0
2 0 0 0 0 2 0 2 0 0 0 0 2 0 2 0 0 0 0 2 0 2 0 3 4 2 0 2 0 2 0 2 0 2 0 2 0 5 6 6 7 0 2 0 5 6 6 7 0 2
0 5 6 6 7 0 2 2 0 2 0 2 0 2 0 2 0 2 0 5 6 6 7 0 2 0 5 6 6 7 0 2 0 5 6 6 7 0 2 0 5 6 6 7 0 2 0 5 6 6
7 0 2 0 5 6 6 7 4 2 0 2 0 2 0 2 0 2 0 2 0 2 0 0 0 0 2 0 2 0 0 0 0 2 0 2 0 0 0 0 2 0 2 0 0 0 0 2 0 2
0 0 0 0 2 0 2 0 0 0 4 2 0 2 0 2 0 2 0 2 0 2 0 2 0 5 6 6 7 0 2 0 5 6 6 7 0 2 0 5 6 6 7 0 2 0 5 6 6 7
0 2 0 5 6 6 7 0 2 0 5 6 7 4 2 0 2 0 2 0 2 0 2 0 2 0 2 0 2 0 0 0 0 2 0 2 0 0 0 0 2 0 2 0 0 0 0 2 0 2
0 0 0 0 2 0 2 0 0 0 0 2 0 2 0 0 0 4 2 0 2 0 2 0 2 0 2 0 2 0 2 0 2 0 5 6 6 7 0 2 0 5 6 6 7 0 2 0 5 6
6 7 0 2 0 5 6 6 7 0 2 0 5 6 6 7 0 2 0 5 6 7 4 2 0 2 0 2 0 2 0 2 0 2 0 2 0 2 0 2 0 0 0 0 2 0 2 0 0 0
0 2 0 2 0 0 0 0 2 0 2 0 0 0 0 2 0 2 0 0 0 0 2 0 2 0 0 0 4 2 0 2 0 2 0 2 0 2 0 2 0 2 0 2 0 2 0 5 6 6
7 0 2 0 5 6 6 7 0 2 0 5 6 6 7 0 2 0 5 6 6 7 0 2 0 5 6 6 7 0 2 0 5 6 6 7 4 2 0 2 0 2 0 2 0 2 0 2 0 2
0 2 0 2 0 2 0 0 0 0 2 0 2 0 0 0 0 2 0 2 0 0 0 0 2 0 2 0 0 0 0 2 0 2 0 0 0 0 2 0 2 0 0 0 4 2 0 2 0 2
0 2 0 2 0 2 0 2 0 2 0 2 0 2 0 5 6 6 7 0 2 0 5 6 6 7 0 2 0 5 6 6 7 0 2 0 5 6 6 7 0 2 0 5 6 6 7 0 2 0
5 6 7 4 2 0 2 0 2 0 2 0 2 0 2 0 2 0 2 0 2 0 2 0 2 0 0 0 0 2 0 2 0 0 0 0 2 0 2 0 0 0 0 2 0 2 0 0 0 0
2 0 2 0 0 0 0 2 0 2 0 0 0 4 2 0 2 0 2 0 2 0 2 0 2 0 2 0 2 0 2 0 2 0 2 0 5 6 6 7 0 2 0 5 6 6 7 0 2 0
5 6 6 7 0 2 0 5 6 6 7 0 2 0 5 6 2 0 2 0 2 0 2 0 2 0 2 0 2 0 2 0 2 0 2 0 2 0 5 6 6 7 0 2 0 5 6 6 7 0
2 0 5 6 6 7 0 2 0 5 6 6 7 0 2 0 5 6 7 4 2 0 2 0 2 0 2 0 2 0 2 0 2 0 2 0 2 0 2 0 2 0 2 0 0 0 0 2 0 2
0 0 0 0 2 0 2 0 0 0 0 2 0 2 0 0 0 0 2 0 2 0 0 0 4 2 0 2 0 2 0 2 0 2 0 2 0 2 0 2 0 2 0 2 0 2 0 2 0 5
6 6 7 0 2 0 5 6 6 7 0 2 0 5 6 6 7 0 2 0 5 6 6 7 0 2 0 5 6 7 4 2 0 2 0 2 0 2 0 2 0 2 0 2 0 2 0 2 0 2
0 2 0 2 0 2 0 0 0 0 2 0 2 0 0 0 0 2 0 2 0 0 0 0 2 0 2 0 0 0 0 2 0 2 0 0 0 4 2 0 2 0 2 0 2 0 2 0 2 0
2 0 2 0 2 0 2 0 2 0 2 0 2 0 5 6 6 7 0 2 0 5 6 6 7 0 2 0 5 6 6 7 0 2 0 5 6 6 7 0 2 0 5 6 6 7 4 2 0 2
0 2 0 2 0 2 0 2 0 2 0 2 0 2 0 2 0 2 0 2 0 2 0 2 0 0 0 0 2 0 2 0 0 0 0 2 0 2 0 0 0 0 2 0 2 0 0 0 0 2
0 2 0 0 0 4 2 0 2 0 2 0 2 0 2 0 2 0 2 0 2 0 2 0 2 0 2 0 2 0 2 0 2 0 5 6 6 7 0 2 0 5 6 6 7 0 2 0 5 6
6 7 0 2 0 5 6 6 7 0 2 0 5 6 7 4 2 0 2 0 2 0 2 0 2 0 2 0 2 0 2 0 2 0 2 0 2 0 2 0 2 0 2 0 2 0 0 0 0 2
0 2 0 0 0 0 2 0 2 0 0 0 0 2 0 2 0 0 0 0 2 0 2 0 0 0 4 2 0 2 0 2 0 2 0 2 0 2 0 2 0 2 0 2 0 2 0 2 0 2
0 2 0 2 0 2 0 5 6 6 7 0 2 0 5 6 6 7 0 2 0 5 6 6 7 0 2 0 5 6 6 7 0 2 0 5 6 7 4 2 0 2 0 2 0 2 0 2 0 2
0 2 0 2 0 2 0 2 0 2 0 2 0 2 0 2 0 2 0 2 0 0 0 0 2 0 2 0 0 0 0 2 0 2 0 0 0 0 2 0 2 0 0 0 0 2 0 2 0 0
0 4 2 0 2 0 2 0 2 0 2 0 2 0 2 0 2 0 2 0 2 0 2 0 2 2 0 2 0 2 0 2 0 2 0 2 0 2 0 2 0 2 0 2 0 2 0 2 0 2
0 5 6 6 7 0 2 0 5 6 6 7 0 2 0 5 6 6 7 0 2 0 5 6 6 7 0 2 0 5 6 7 4 2 0 2 0 2 0 2 0 2 0 2 0 2 0 2 0 2
0 2 0 2 0 2 0 2 0 2 0 0 0 0 2 0 2 0 0 0 0 2 0 2 0 0 0 0 2 0 2 0 0 0 0 2 0 2 0 0 0 4 2 0 2 0 2 0 2 0
2 0 2 0 2 0 2 0 2 0 2 0 2 0 2 0 2 0 5 6 6 7 0 2 0 5 6 6 7 0 2 0 5 6 6 7 0 2 0 5 6 6 7 0 2 0 5 6 7 4
2 0 2 0 2 0 2 0 2 0 2 0 2 0 2 0 2 0 2 0 2 0 2 0 2 0 2 0 2 0 0 0 0 2 0 2 0 0 0 0 2 0 2 0 0 0 0 2 0 2
0 0 0 0 2 0 2 0 0 0 4 2 0 2 0 2 0 2 0 2 0 2 0 2 0 2 0 2 0 2 0 2 0 2 0 2 0 5 6 6 7 0 2 0 5 6 6 7 0 2
0 5 6 6 7 0 2 0 5 6 6 7 0 2 0 5 6 6 7 4 2 0 2 0 2 0 2 0 2 0 2 0 2 0 2 0 2 0 2 0 2 0 2 0 2 0 2 0 0 0
0 2 0 2 0 0 0 0 2 0 2 0 0 0 0 2 0 2 0 0 0 0 2 0 2 0 0 0 4 2 0 2 0 2 0 2 0 2 0 2 0 2 0 2 0 2 0 2 0 2
0 2 0 2 0 2 0 5 6 6 7 0 2 0 5 6 6 7 0 2 0 5 6 6 7 0 2 0 5 6 6 7 0 2 0 5 6 7 4 2 0 2 0 2 0 2 0 2 0 2
0 2 0 2 0 2 0 2 0 2 0 2 0 2 0 2 0 2 0 0 0 0 2 0 2 0 0 0 0 2 0 2 0 0 0 0 2 0 2 0 0 0 0 2 0 2 0 0 0 4
2 0 2 0 2 0 2 0 2 0 2 0 2 0 2 0 2 0 2 0 2 0 2 0 2 0 2 0 2 0 5 6 6 7 0 2 0 5 6 6 7 0 2 0 5 6 6 7 0 2
0 5 6 6 7 0 2 0 5 6 7 4 2 0 2 0 2 0 2 0 2 0 2 0 2 0 2 0 2 0 2 0 2 0 2 0 2 0 2 0 2 0 2 0 0 0 0 2 0 2
0 0 0 0 2 0 2 0 0 0 0 2 0 2 0 0 0 0 2 0 2 0 0 0 4 2 0 2 0 2 0 2 0 2 2 0 2 0 2 0 2 0 2 0 2 0 2 0 2 0